W W W W W W W W W W W W W 
W - - - - - C - - S - - W
W - E - - C H C P - K - W
W - - - - - C - - - - - W
W - - - - C - - - - - - W
W H - - H - - - - - - - W
W - - - H - - - - - - - W
W C C - H - - - - - P - W
W C C - - C - - - - - - W
W W W W W W W W W W W W W